абориген = абуриген
абстрахирам = апстрахирам
адски = ацки
азиатец = азиятец
актуално - актоално
акумулатор = акомулатор
алфа-лъчи = алфа лъчи
амулет = амолет
анцуг = анцунг
астигматизъм = астегматизъм
асфалт = асвалт
бардак = бърдак
батерии = батерий
бедствие = бетствие
безогледен = безугледен
безопасност = безопастност
безпокоя = безспокоя
безскрупулен = безкруполен
безследно = беследно
безсмислен = бесмислен
безсмислие = безмислие
безспорен = безпорен
безспорно = беспорно
безсъвестен = бесъвестен
безучастен = безучасен
бележка = белешка
бенка = бемка
беседка = бесетка
биберон = беберон
бицепс = бицебс
боклук = буклук
болтче = болче
бомбардирам = бомбандирам
бомбе = бумбе
братовчед = братовчет
бръмбар = бръмбър
бръмчат = брамчът
будалкам = бодалкам
будка = бутка
буксувам = боксувам
буржоазия = буржуазия
бъзик = базик
бъзици = базици
бълха = балха
бърлога = барлога
бюджет = бюджед
вакуум = вакум
вариант = вариянт
вестник = весник
взема = зема
випускник = випусник
висшестоящ = вишестоящ
висшист = вишист
витрина = ветрина
вкъщи = в къщи
военачалник = военоначалник
впоследствие = в последствие
временно = времено
връзка = връска
вследствие = в следствие
вулкан = волкан
въз основа на = възоснова на
възвръщаемост = възвращаемост
възпирам = възспирам
възраст = възръст
възстановявам = възтановявам
въоръжен = въоражен
въоръжение = въоражение
вървели = вървяли
въставам = възставам
въстание = възстание
въстаник = възстаник
вятър = вятар
генетична = генитична
героите = геройте
гигантски = гигандски
гладка = глатка
гладки = глатки
гледка = глетка
глухонемота = глухонямота
глътка = глъдка
гозба = гостба
графство = гравство
грък = гърк
дандания = дъндания
двоеточие = двуеточие
двоични = двуични
двойствен = двойнствен
двойственост = двойнственост
двоумя се = двуомя се
двуличник = дволичник
двуцевка = двоцефка
деветка = девятка
девствен = дествен
девственост = дественост
дезертирам = дизертирам
дезертьор = дизертьор
деменция = дименция
десетка = десятка
детски = децки
джоб = джоп
джоджен = джоджан
дисидент = десидент
дискомфорт = дизкомфорт
довод = довот
докато = докъто
долар = долър
досег = досек
древногръцки = древно-гръдски
дроид = друид
дузина = дозина
дузпа = дуспа
дундуркам = дондуркам
духовит = дохувит
дълбок = далбок
дълъг = дълаг
евтаназия = ефтаназия
евфемизъм = ефемизъм
едър = едар
еликсир = елексир
емигрант = имигрант
енергийна = енергиина
енергийни = енергиини
ерудиран = еродиран
еспресо = експресо
женитба = женидба
живописта = живопистта
жилав = жилъв
жираф = жирав
забива = зъбива
загадка = загатка
загърбвам = задгърбвам
заек = заяк
заимствам = взаимствам
заместник = замесник
замразен = замръзен
записал = записъл
заслужава = засложава
здравейте = здравей те
зодиак = зодияк
зрялост = зрелост
идентичен = едентичен
из ведро = изведро
избраник = избранник
изведнъж = изведнъш
известно = извесно
издържа = издаржа
изземам = извземам
изключение = исключение
изнесат = изнесът
изписвам = изсписвам
изпит = изспит
използвам = исползвам
изпотен = изспотен
изпускам = изспускам
изскочи = изкочи
изстинал = изтинал
изстискам = изтискам
изстрел = изтрел
източник = изсточник
изтребител = изстребител
иконописта = иконопистта
именно = имено
иначе = инъче
инженер = инжинер
инкубация = инкобация
искам = изкам
искра = изкра
искрено = искренно
истерия = изстерия
италианец = италиянец
италиански = италиянски
йероглиф = ероглиф
йогурт = йогорт
какофония = какафония
калдъръм = калдаръм
калций = калции
калъф = калъв
канавка = канафка
картечница = къртечница
картофки = картовки
карфица = кърфица
кебапче = кебабче
книжка = книшка
ковчег = кофчег
коефициент = коефицент
кокал = кокъл
колиба = кулиба
комик = кумик
комин = кумин
компрометирам = компроментирам
комфортно = конфортно
конвейер = конвейр
консумация = консомация
контузия = кунтузия
конфигурация = конфигорация
коригирам = корегирам
корпорация = корпурация
кофраж = куфраж
крадат = крадът
кренвирш = кремвирш
критерий = критерии
кумир = комир
куплунг = коплунг
купувам = копувам
купувач = куповач
кураж = кораж
куртоазия = куртуазия
куфар = куфър
кървав = кървъв
лавка = лафка
лакът = лакет
лиана = лияна
лимонтузу = лимонтозу
луминисценция = луменисценция
маниак = манияк
мания = маниа
махмурлук = махморлук
мекушав = мекошав
мерудия = меродия
мирис = мириз
мушморок = мушмурок
намордник = наморник
напреднал = напреднъл
не знам = незнам
невинаги = не винаги
негодувание = негудувание
немарлив = немърлив
неслучайно = не случайно
неугледен = неогледен
обкръжение = обкражение
огорчавам = угорчавам
одеяло = одеало
одобрение = удобрение
одобрителен = удобрителен
одобрявам = удобрявам
окраска = украска
омбудсман = омбуцман
оредели = уредели
ориста = ористта
особено = особенно
отвертка = отверка
папийонка = папйонка
пиедестал = пиадестал
пластилин = пластелин
подкокоросвам = подкукоросвам
подплатявам = подплътявам
Поликраище = Поликрайще
полилей = полюлей
потискам = подтискам
предвид = впредвид
предразсъдък = предразсъдак
презумпция = презумция
претекст = предтекст
привилегия = превилегия
придирчив = предирчив
прищипан = прещипан
пуловер = половер
пунктуация = пунктоация
пустошта = пустощта
пъдпъдък = падпъдък
разочарование = разочерование
разтакавам = ръзтакавам
риванол = реванол
рикошет = рекушет
сарма = сърма
сбием = збием
сблъсквам = зблъсквам
сбогом = збогом
сборник = зборник
свещено = свещенно
сглобка = зглобка
сграда = зграда
сияние = сиание
скилидка = скилитка
случай = случей
списък = списак
статукво = статуктво
странноприемница = страноприемница
съжалявам = съжелявам
сякаш = всякаш
току-що = току що
трансцендентен = трансцедентен
у дома = удома
убождам = обождам
уголемявам = огулемявам
удвоен = одвуен
удебелявам = одебелявам
уеднаквявам = оеднъквявам
ужилвам = ожилвам
улук = олук
умивалник = омивалник
умърлушвам се = умарлушвам се
унаследен = онаследен
уплътнявам = уплатнявам
усмърдявам = усмардявам
утаечен = утаячен
утъпкан = отъпкан
учудвам = очудвам 
фасонка = фасунка
фелдфебел = фелфебел
фин = финен
фина = финна
фойерверки = фоерверки
фъстъци = фастъци
цървул = царвул
чифт = чивт
чувствам = чуствам
шумоля = шумуля
юрисконсулт = юристконсулт
