невинаги = не винаги
окраска = украска
кураж = кораж
йогурт = йогорт
вестник = весник
кренвирш = кремвирш
дузина = дозина
подкокоросвам = подкукоросвам
връзка = връска
гледка = глетка
изведнъж = изведнъш
негодувание = негудувание
двоумя се = двуомя се
изземам = извземам
риванол = реванол
одеяло = одеало
пустошта = пустощта
девствен = дествен
будка = бутка
буксувам = боксувам
братовчед = братовчет
грък = гърк
бръмбар = бръмбър
странноприемница = страноприемница
духовит = дохувит
изстрел = изтрел
пластилин = пластелин
уеднаквявам = оеднъквявам
дълбок = далбок
списък = списак
довод = довот
комик = кумик
пиедестал = пиадестал
батерии = батерий
загърбвам = задгърбвам
лиана = лияна
дроид = друид
кофраж = куфраж
забива = зъбива
Поликраище = Поликрайще
безсъвестен = бесъвестен
двуцевка = двоцефка
военачалник = военоначалник
убождам = обождам
истерия = изстерия
из ведро = изведро
алфа-лъчи = алфа лъчи
книжка = книшка
утъпкан = отъпкан
заек = заяк
долар = долър
двоеточие = двуеточие
конфигурация = конфигорация
евтаназия = ефтаназия
възраст = възръст
скилидка = скилитка
пъдпъдък = падпъдък
съжалявам = съжелявам
витрина = ветрина
въоръжен = въоражен
разтакавам = ръзтакавам
издържа = издаржа
записал = записъл
кървав = кървъв
впоследствие = в последствие
конвейер = конвейр
уплътнявам = уплатнявам
сякаш = всякаш
бенка = бемка
компрометирам = компроментирам
мерудия = меродия
искрено = искренно
неслучайно = не случайно
корпорация = корпурация
мания = маниа
изнесат = изнесът
двуличник = дволичник
фелдфебел = фелфебел
дискомфорт = дизкомфорт
прищипан = прещипан
зодиак = зодияк
кокал = кокъл
временно = времено
иначе = инъче
евфемизъм = ефемизъм
куфар = куфър
потискам = подтискам
бомбардирам = бомбандирам
дисидент = десидент
огорчавам = угорчавам
деменция = дименция
особено = особенно
вървели = вървяли
пуловер = половер
искам = изкам
дезертьор = дизертьор
едър = едар
одобрителен = удобрителен
предвид = впредвид
мекушав = мекошав
гигантски = гигандски
калдъръм = калдаръм
безсмислен = бесмислен
генетична = генитична
въставам = възставам
бардак = бърдак
сглобка = зглобка
оредели = уредели
чифт = чивт
усмърдявам = усмардявам
подплатявам = подплътявам
енергийна = енергиина
пунктуация = пунктоация
лавка = лафка
вятър = вятар
маниак = манияк
безопасност = безопастност
двоични = двуични
ориста = ористта
героите = геройте
известно = извесно
възстановявам = възтановявам
немарлив = немърлив
висшестоящ = вишестоящ
изскочи = изкочи
досег = досек
обкръжение = обкражение
юрисконсулт = юристконсултвъстаник = възстаник
омбудсман = омбуцман
вследствие = в следствие
жираф = жирав
изписвам = изсписвам
бръмчат = брамчът
унаследен = онаследен
абстрахирам = апстрахирам
картофки = картовки
сбием = збием
изключение = исключение
изпускам = изспускам
чувствам = чуствам
безсмислие = безмислие
одобрявам = удобрявам
фасонка = фасунка
джоб = джоп
бърлога = барлога
ерудиран = еродиран
еликсир = елексир
цървул = царвул
анцуг = анцунг
деветка = девятка
луминисценция = луменисценция
инженер = инжинер
привилегия = превилегия
фойерверки = фоерверки
дандания = дъндания
мушморок = мушмурок
фин = финен
фина = финна
коригирам = корегирам
сияние = сиание
карфица = кърфица
випускник = випусник
искра = изкра
купувач = куповач
калций = калции
у дома = удома
заместник = замесник
взема = зема
ковчег = кофчег
безогледен = безугледен
трансцендентен = трансцедентен
възвръщаемост = възвращаемост
комин = кумин
махмурлук = махморлук
предразсъдък = предразсъдак
амулет = амолет
енергийни = енергиини
джоджен = джоджан
изпотен = изспотен
кумир = комир
въоръжение = въоражение
висшист = вишист
бележка = белешка
коефициент = коефицент
статукво = статуктво
безследно = беследно
изтребител = изстребител
колиба = кулиба
адски = ацки
бълха = балха
утаечен = утаячен
заслужава = засложава
загадка = загатка
двойственост = двойнственост
куплунг = коплунг
глухонемота = глухонямота
женитба = женидба
инкубация = инкобация
сборник = зборник
изпит = изспит
рикошет = рекушет
биберон = беберон
будалкам = бодалкам
древногръцки = древно-гръдски
сбогом = збогом
купувам = копувам
напреднал = напреднъл
сблъсквам = зблъсквам
лимонтузу = лимонтозу
замразен = замръзен
бъзици = базици
отвертка = отверка
уголемявам = огулемявам
картечница = къртечница
сарма = сърма
не знам = незнам
вариант = вариянт
полилей = полюлей
докато = докъто
разочарование = разочерование
крадат = крадът
вулкан = волкан
въстание = възстание
мирис = мириз
калъф = калъв
шумоля = шумуля
консумация = консомация
актуално = актоално
комфортно = конфортно
живописта = живопистта
двойствен = двойнствен
десетка = десятка
току-що = току що
здравейте = здравей те
удвоен = одвуен
бюджет = бюджед
избраник = избранник
бъзик = базик
възпирам = възспирам
безучастен = безучасен
изстискам = изтискам
презумпция = презумция
безскрупулен = безкруполен
беседка = бесетка
умивалник = омивалник
свещено = свещенно
бедствие = бетствие
удебелявам = одебелявам
намордник = наморник
сграда = зграда
безспорно = беспорно
канавка = канафка
девственост = дественост
безспорен = безпорен
италиански = италиянски
гладка = глатка
италианец = италиянец
папийонка = папйонка
използвам = исползвам
одобрение = удобрение
кебапче = кебабче
гладки = глатки
еспресо = експресо
иконописта = иконопистта
графство = гравство
ужилвам = ожилвам
дундуркам = дондуркам
глътка = глъдка
акумулатор = акомулатор
бомбе = бумбе
претекст = предтекст
критерий = критерии
куртоазия = куртуазия
емигрант = имигрант
именно = имено
дълъг = дълаг
изстинал = изтинал
боклук = буклук
вакуум = вакум
лакът = лакет
детски = децки
буржоазия = буржуазия
болтче = болче
дезертирам = дизертирам
учудвам = очудвам 
асфалт = асвалт
йероглиф = ероглиф
астигматизъм = астегматизъм
контузия = кунтузия
придирчив = предирчив
абориген = абуриген
фъстъци = фастъци
неугледен = неогледен
бицепс = бицебс
жилав = жилъв
азиатец = азиятец
какофония = какафония
улук = олук
зрялост = зрелост
дузпа = дуспа
въз основа на = възоснова на
заимствам = взаимствам
идентичен = едентичен
умърлушвам се = умарлушвам се
безпокоя = безспокоя
източник = изсточник
гозба = гостба
случай = случей
вкъщи = в къщи
